_WWWW_______
W____WW_____
W__PBS_W____
_WWWWWW_____
____________
