12
5
_WWWW_______
W____WW_____
W__PB_SW____
_WWWWWW_____
____________
