5
7
WWWWW
WS SW
W BPW
WBBBW
W B W
WSSSW
WWWWW
