WWWWWWWW
WS WW  W
WS  BB W
WS BB PW
WSWW   W
WWWWWWWW
