12
7
WWWWWWWWWW_
W    W  SW_
W WBWWB WWW
W  B    SSW
W W  WB WWW
W   PW  SW_
WWWWWWWWWW_
