WWWWWWWW
WSSSWSSW
W B WB W
W BWW  W
W B B  W
W    P W
WWWWWWWW
