WWWWWWWW
W    WSW
W WB . W
W B  WPW
W WWBW W
WS    SW
WWWWWWWW
