_WWWWWW__
WW  SPWW_
W . W  WW
W   W   W
W BWW W W
W  B B.SW
W  SW   W
WWWWWWWWW
