_WWWWWWW__
_WSSSS W__
WWWSSSBWWW
W  BWB B W
W BB  WB W
W    W   W
WWWW P WWW
___WWWWW__
