WWWWWWWWWW
WS B    SW
WSPWW.B SW
W B .  B W
W  WW.W SW
WWSB  B. W
WWWWW    W
WWWWWWWWWW
