_____WWWWW_
WWWWWW   W_
W S SSSBSWW
W WBBB B  W
W  BPBBBW W
WWSBSSS S W
_W   WWWWWW
_WWWWW_____
