WWWWWWW
W  S  W
W BWB W
WS .PSW
W BWB W
W  S  W
WWWWWWW
