WWWWWWWWWWWWWWW
WWWSW      WWWW
WWSSW B  B W  W
WSSSW WW B B  W
WSSSSS  WBB   W
WWSSSSB    WB W
WWWW WWWWWWW  W
W   B        WW
W  B W  BW B WW
W BWWW B W BB W
W   PW  WW    W
WWWWWWWWWWWWWWW
