_WWWWWW
_WSSSSW
WW W  W
W PB  W
W WBB W
W B W W
WWW   W
__WWWWW
