_____WWWW____
_WWWWW__WWWWW
WPB    B  B W
WBWWW B W W W
W  W  W B   W
W BW    W WWW
W  B WBW   W_
WSSSSSSSSS W_
WWWWWWWW   W_
_______WWWWW_
