WWWWW___
W   W___
W  BWWWW
WS.P.  W
W BB.  W
W   S  W
WWWWWWWW
