_WWWWWWWWWW
_WSS  P   W
_WWSWWWWW W
WWWSW   W W
W  SW  BW W
W BB    B W
W  WB  WWWW
WWWW   W___
___WWWWW___
