_WWWWW___
_W   WWW_
_W W B W_
WWBS S W_
W   W WWW
W WS SB W
W  B W  W
WWWW P WW
___WWWWW_
