WWWWWWW
W  S  W
W  SB W
W B.S W
W. SB.W
W ..B W
W  SB W
W BS PW
WWWWWWW
