_WWWWWWWWW_
_W   P   W_
_W B B B W_
WWWBWBWB WW
W  B B B  W
W  B W WW W
WW W WSSS W
_W W WSWSSW
_W    SSSSW
_WWWWWW  WW
______WWWW_
