WWWWWWW
WS   SW
W B.B W
W .P. W
W B.B W
WS   SW
WWWWWWW
