WWWWW_____
W   WWWWWW
W B SS B W
WWB SSBBPW
_W  SS B W
_WWWWWWWWW
