WWWWW_____
W   WWWWWW
W . SS . W
WW. SS..PW
_W  SS . W
_WWWWWWWWW
