_WWWWWWWWWWWWWWWWW
WWSSSSSW     W   W
WSSSSSSW BB  B B W
WSSSWWWWW   WB   W
WWSSB     WWW  B W
W   W WWWWW PW B W
W   W B  B BB BW W
WWWW  B  B    B  W
___W W WWWWWWWWWWW
___W   W__________
___WWWWW__________
