WWWWWWW
W  .  W
W PSB W
W BS  W
W.S...W
W  .  W
W B.B W
W  S  W
WWWWWWW
